NO ./path_to_the_north_texture
SO ./path_to_the_south_texture
WE ./path_to_the_west_texture
EA ./path_to_the_east_texture

F 220,100,0
C 255, 0, 0

1111111111111111
1111011111111111
1100000011010111
1000000000000011
100E000000000011
1100000111010111
1111011111110111
1111111111111111
