NO ./textures/greystone.xpm
EA ./textures/mossy.xpm

F 220,100,0

SO ./textures/redbrick.xpm
WE ./textures/colorstone.xpm

C 128, 196, 255

        1111111111111111111111111
        1000000000110000000000001
        1011000001110000000000001
        1001000000000000000000001
111111111011000001110000000000001
100000000011000001110111111111111
11110111111111011100000010001
11110111111111011101010010001
11000000110101011100000010001
10000000000000001100000010001
10000000000000001101010010001
11000S0111010101111101111000111
1111011111110101 101111010001
11111111 1111111 111111111111
